type octile
height 7
width 10
map
@@@@@@@@@@
@...WWW..@
@..TW.W..@
@T..T....@
@.T....TT@
@...TT...@
@@@@@@@@@@